Genotype,Replication,flower_W2_Control,flower_W2_Drought,flower_W3_Control,flower_W3_Drought,flower_W4_Control,flower_W4_Drought,flower_W5_Control,flower_W5_Drought,flower_cum_W2_Control,flower_cum_W2_Drought,flower_cum_W3_Control,flower_cum_W3_Drought,flower_cum_W4_Control,flower_cum_W4_Drought,flower_cum_W5_Control,flower_cum_W5_Drought
DG_F3_004,1,0,0,1,0,1,1,0,0,0,0,1,0,2,1,2,1
DG_F3_007,1,0,0,0,0,1,1,2,0,0,0,0,0,1,1,3,1
DG_F3_008,1,2,0,0,0,2,0,5,0,2,0,2,0,4,0,9,0
DG_F3_009,1,0,0,1,0,0,2,1,0,0,0,1,0,1,2,2,2
DG_F3_011,1,0,0,1,1,2,3,8,2,0,0,1,1,3,4,11,6
DG_F3_013,1,0,0,1,0,2,1,2,4,0,0,1,0,3,1,5,5
DG_F3_015,1,0,0,0,1,6,4,8,7,0,0,0,1,6,5,14,12
DG_F3_017,1,0,0,1,1,4,12,3,5,0,0,1,1,5,13,8,18
DG_F3_019,1,0,0,0,1,1,1,2,7,0,0,0,1,1,2,3,9
DG_F3_020,1,1,1,1,0,7,5,3,5,1,1,2,1,9,6,12,11
DG_F3_022,1,0,0,1,1,3,5,5,5,0,0,1,1,4,6,9,11
DG_F3_024,1,0,0,2,2,2,1,3,3,0,0,2,2,4,3,7,6
DG_F3_028,1,0,0,2,3,5,3,10,3,0,0,2,3,7,6,17,9
DG_F3_032,1,0,1,2,1,1,3,12,8,0,1,2,2,3,5,15,13
DG_F3_033,1,0,0,0,4,0,2,1,0,0,0,0,4,0,6,1,6
DG_F3_038,1,0,0,4,2,3,3,7,6,0,0,4,2,7,5,14,11
DG_F3_040,1,0,1,2,5,6,4,9,8,0,1,2,6,8,10,17,18
DG_F3_042,1,0,0,2,2,0,5,6,4,0,0,2,2,2,7,8,11
DG_F3_049,1,0,0,0,0,0,0,0,0,0,0,0,0,0,0,0,0
DG_F3_051,1,0,0,0,0,0,0,2,4,0,0,0,0,0,0,2,4
DG_F3_054,1,0,0,1,3,4,1,7,8,0,0,1,3,5,4,12,12
DG_F3_056,1,0,0,0,0,0,1,3,2,0,0,0,0,0,1,3,3
DG_F3_057,1,0,0,3,3,5,3,5,1,0,0,3,3,8,6,13,7
DG_F3_059,1,1,0,3,2,4,5,6,4,1,0,4,2,8,7,14,11
DG_F3_063,1,0,0,2,1,1,1,7,4,0,0,2,1,3,2,10,6
DG_F3_066,1,0,0,0,0,0,0,1,1,0,0,0,0,0,0,1,1
DG_F3_068,1,0,0,1,0,4,2,1,3,0,0,1,0,5,2,6,5
DG_F3_069,1,1,0,2,2,3,8,9,6,1,0,3,2,6,10,15,16
DG_F3_070,1,0,0,0,0,5,1,3,4,0,0,0,0,5,1,8,5
DG_F3_075,1,0,0,0,0,6,3,2,5,0,0,0,0,6,3,8,8
DG_F3_076,1,0,0,0,0,2,3,6,2,0,0,0,0,2,3,8,5
DG_F3_077,1,0,0,0,2,10,4,10,5,0,0,0,2,10,6,20,11
DG_F3_081,1,0,0,0,0,0,3,0,1,0,0,0,0,0,3,0,4
DG_F3_082,1,0,0,0,0,3,1,2,3,0,0,0,0,3,1,5,4
DG_F3_085,1,0,0,2,0,0,5,6,2,0,0,2,0,2,5,8,7
DG_F3_088,1,0,0,0,0,0,1,4,1,0,0,0,0,0,1,4,2
DG_F3_090,1,0,0,0,1,0,3,2,1,0,0,0,1,0,4,2,5
DG_F3_092,1,0,0,0,0,0,1,2,5,0,0,0,0,0,1,2,6
DG_F3_093,1,0,0,1,1,1,3,8,8,0,0,1,1,2,4,10,12
DG_F3_094,1,0,0,1,1,0,1,6,4,0,0,1,1,1,2,7,6
DG_F3_095,1,0,0,0,0,2,3,9,2,0,0,0,0,2,3,11,5
DG_F3_096,1,0,0,2,1,3,4,1,7,0,0,2,1,5,5,6,12
DG_F3_097,1,0,1,0,1,2,0,3,2,0,1,0,2,2,2,5,4
DG_F3_098,1,1,1,3,1,6,2,2,1,1,1,4,2,10,4,12,5
DG_F3_099,1,0,0,1,2,0,1,1,1,0,0,1,2,1,3,2,4
DG_F3_101,1,0,0,2,5,2,2,4,4,0,0,2,5,4,7,8,11
DG_F3_102,1,0,1,2,1,2,1,2,1,0,1,2,2,4,3,6,4
DG_F3_103,1,0,0,0,3,2,0,3,2,0,0,0,3,2,3,5,5
DG_F3_106,1,0,0,1,0,0,3,0,1,0,0,1,0,1,3,1,4
DG_F3_107,1,0,0,0,0,0,0,0,0,0,0,0,0,0,0,0,0
DG_F3_115,1,0,1,2,2,0,1,3,3,0,1,2,3,2,4,5,7
DG_F3_118,1,0,0,0,0,0,0,1,2,0,0,0,0,0,0,1,2
DG_F3_119,1,0,0,3,3,2,3,5,0,0,0,3,3,5,6,10,6
DG_F3_120,1,0,0,4,1,5,3,11,1,0,0,4,1,9,4,20,5
DG_F3_121,1,0,0,2,2,2,1,2,2,0,0,2,2,4,3,6,5
DG_F3_124,1,0,0,2,2,0,0,4,2,0,0,2,2,2,2,6,4
DG_F3_126,1,0,1,2,3,2,3,7,3,0,1,2,4,4,7,11,10
DG_F3_127,1,0,0,3,0,3,5,6,4,0,0,3,0,6,5,12,9
DG_F3_129,1,0,0,2,1,0,2,2,1,0,0,2,1,2,3,4,4
DG_F3_131,1,0,0,2,2,4,1,3,7,0,0,2,2,6,3,9,10
DG_F3_132,1,0,0,1,1,5,5,5,6,0,0,1,1,6,6,11,12
DG_F3_133,1,0,1,2,3,2,6,2,2,0,1,2,4,4,10,6,12
DG_F3_136,1,0,0,5,3,0,4,3,10,0,0,5,3,5,7,8,17
DG_F3_139,1,1,1,1,2,6,2,6,8,1,1,2,3,8,5,14,13
DG_F3_145,1,0,0,8,0,1,3,7,2,0,0,8,0,9,3,16,5
DG_F3_150,1,1,1,3,4,2,5,6,1,1,1,4,5,6,10,12,11
DG_F3_152,1,0,0,3,4,3,2,5,0,0,0,3,4,6,6,11,6
DG_F3_154,1,0,0,4,2,2,2,2,3,0,0,4,2,6,4,8,7
DG_F3_157,1,0,0,0,3,2,2,3,0,0,0,0,3,2,5,5,5
DG_F3_159,1,0,0,1,0,3,4,0,2,0,0,1,0,4,4,4,6
DG_F3_163,1,0,0,0,0,1,2,6,1,0,0,0,0,1,2,7,3
DG_F3_164,1,0,0,2,2,5,5,1,1,0,0,2,2,7,7,8,8
DG_F3_165,1,0,1,1,4,5,5,4,3,0,1,1,5,6,10,10,13
DG_F3_167,1,0,0,2,0,0,2,0,1,0,0,2,0,2,2,2,3
DG_F3_175,1,0,0,0,0,7,6,0,2,0,0,0,0,7,6,7,8
DG_F3_179,1,0,0,0,1,5,5,2,1,0,0,0,1,5,6,7,7
DG_F3_180,1,0,0,2,1,1,1,2,2,0,0,2,1,3,2,5,4
DG_F3_185,1,0,0,3,4,6,6,7,1,0,0,3,4,9,10,16,11
DG_F3_190,1,0,1,2,5,4,7,2,1,0,1,2,6,6,13,8,14
DG_F3_194,1,0,0,2,4,8,2,10,4,0,0,2,4,10,6,20,10
DG_F3_195,1,0,0,3,1,4,1,1,2,0,0,3,1,7,2,8,4
DG_F3_196,1,0,0,0,0,2,2,1,1,0,0,0,0,2,2,3,3
DG_F3_200,1,0,1,1,2,5,3,7,1,0,1,1,3,6,6,13,7
DG_F3_203,1,0,0,0,0,2,2,3,0,0,0,0,0,2,2,5,2
DG_F3_210,1,0,0,1,1,6,7,4,5,0,0,1,1,7,8,11,13
DG_F3_212,1,0,0,1,2,1,0,3,1,0,0,1,2,2,2,5,3
DG_F3_214,1,0,0,0,0,0,1,2,0,0,0,0,0,0,1,2,1
DG_F3_218,1,0,0,0,0,1,1,4,5,0,0,0,0,1,1,5,6
DG_F3_220,1,0,0,0,0,7,3,5,1,0,0,0,0,7,3,12,4
DG_F3_223,1,1,0,2,1,3,3,4,8,1,0,3,1,6,4,10,12
DG_F3_225,1,0,0,1,0,0,0,0,1,0,0,1,0,1,0,1,1
DG_F3_227,1,0,0,2,2,4,2,4,2,0,0,2,2,6,4,10,6
DG_F3_230,1,2,1,2,1,1,4,2,3,2,1,4,2,5,6,7,9
DG_F3_231,1,0,0,0,0,1,3,2,0,0,0,0,0,1,3,3,3
DG_F3_232,1,0,0,1,0,4,1,2,2,0,0,1,0,5,1,7,3
DG_F3_236,1,0,0,3,1,6,7,10,4,0,0,3,1,9,8,19,12
DG_F3_239,1,0,0,0,0,0,0,1,1,0,0,0,0,0,0,1,1
DG_F3_241,1,0,0,0,1,0,0,3,1,0,0,0,1,0,1,3,2
DG_F3_245,1,0,0,0,0,5,4,2,2,0,0,0,0,5,4,7,6
DG_F3_246,1,0,1,2,4,2,0,2,8,0,1,2,5,4,5,6,13
DG_F3_247,1,0,1,0,0,0,0,0,0,0,1,0,1,0,1,0,1
DG_F3_248,1,0,1,2,1,2,3,8,2,0,1,2,2,4,5,12,7
DG_F3_249,1,0,1,0,1,1,1,1,0,0,1,0,2,1,3,2,3
DG_F3_250,1,0,0,2,2,2,0,4,2,0,0,2,2,4,2,8,4
DG_F3_255,1,0,0,2,0,1,0,0,0,0,0,2,0,3,0,3,0
DG_F3_257,1,0,0,0,0,0,0,0,0,0,0,0,0,0,0,0,0
DG_F3_263,1,0,0,0,1,0,1,0,0,0,0,0,1,0,2,0,2
DG_F3_266,1,0,0,4,0,10,1,10,1,0,0,4,0,14,1,24,2
DG_F3_269,1,1,0,1,3,1,2,3,2,1,0,2,3,3,5,6,7
DG_F3_270,1,0,0,0,0,0,3,3,0,0,0,0,0,0,3,3,3
DG_F3_271,1,1,0,0,3,0,1,2,2,1,0,1,3,1,4,3,6
DG_F3_273,1,0,1,6,3,4,1,9,4,0,1,6,4,10,5,19,9
DG_F3_274,1,1,1,1,0,4,1,3,0,1,1,2,1,6,2,9,2
DG_F3_276,1,0,0,2,1,0,1,0,1,0,0,2,1,2,2,2,3
DG_F3_280,1,0,0,1,1,2,0,3,3,0,0,1,1,3,1,6,4
DG_F3_283,1,2,0,2,1,1,2,3,1,2,0,4,1,5,3,8,4
DG_F3_285,1,0,1,4,8,5,4,1,2,0,1,4,9,9,13,10,15
DG_F3_286,1,0,0,1,3,2,0,1,1,0,0,1,3,3,3,4,4
DG_F3_287,1,2,1,0,1,1,3,2,6,2,1,2,2,3,5,5,11
DG_F3_292,1,0,0,0,0,0,0,2,5,0,0,0,0,0,0,2,5
DG_F3_293,1,0,0,1,0,0,1,0,0,0,0,1,0,1,1,1,1
DG_F3_294,1,0,0,0,0,0,0,0,0,0,0,0,0,0,0,0,0
DG_F3_297,1,0,0,0,0,0,0,1,0,0,0,0,0,0,0,1,0
DG_F3_298,1,0,0,1,0,0,1,2,0,0,0,1,0,1,1,3,1
DG_F3_299,1,0,0,0,0,0,2,0,1,0,0,0,0,0,2,0,3
DG_F3_300,1,0,0,1,0,1,2,3,2,0,0,1,0,2,2,5,4
DG_F3_302,1,0,0,1,2,1,4,2,1,0,0,1,2,2,6,4,7
DG_F3_304,1,0,0,2,2,0,3,0,1,0,0,2,2,2,5,2,6
DG_F3_305,1,0,0,3,2,4,2,6,2,0,0,3,2,7,4,13,6
DG_F3_307,1,0,0,1,1,2,1,3,2,0,0,1,1,3,2,6,4
DG_F3_309,1,1,0,2,2,3,1,3,4,1,0,3,2,6,3,9,7
DG_F3_312,1,0,0,2,1,3,2,4,2,0,0,2,1,5,3,9,5
DG_F3_315,1,1,0,4,1,3,2,6,1,1,0,5,1,8,3,14,4
DG_F3_316,1,1,0,1,2,0,1,3,1,1,0,2,2,2,3,5,4
DG_F3_317,1,0,0,1,0,0,0,0,0,0,0,1,0,1,0,1,0
DG_F3_318,1,0,0,0,2,1,1,0,0,0,0,0,2,1,3,1,3
DG_F3_324,1,0,1,1,4,0,2,1,5,0,1,1,5,1,7,2,12
DG_F3_325,1,1,0,2,3,2,3,10,0,1,0,3,3,5,6,15,6
DG_F3_328,1,0,0,1,0,1,1,0,1,0,0,1,0,2,1,2,2
DG_F3_329,1,0,0,1,0,1,2,1,0,0,0,1,0,2,2,3,2
DG_F3_330,1,0,0,1,3,4,0,4,5,0,0,1,3,5,3,9,8
DG_F3_331,1,1,0,0,0,2,1,0,1,1,0,1,0,3,1,3,2
DG_F3_332,1,0,0,3,3,1,2,2,1,0,0,3,3,4,5,6,6
DG_F3_333,1,0,0,2,4,0,3,5,0,0,0,2,4,2,7,7,7
DG_F3_334,1,0,0,0,0,1,3,0,2,0,0,0,0,1,3,1,5
DG_F3_335,1,0,0,1,4,2,1,0,2,0,0,1,4,3,5,3,7
DG_F3_336,1,0,0,3,3,3,2,0,1,0,0,3,3,6,5,6,6
DG_F3_337,1,5,0,1,1,4,3,3,3,5,0,6,1,10,4,13,7
DG_F3_338,1,0,0,1,1,0,1,1,4,0,0,1,1,1,2,2,6
DG_F3_342,1,1,0,3,1,2,3,2,3,1,0,4,1,6,4,8,7
DG_F3_344,2,0,0,0,0,0,0,0,0,0,0,0,0,0,0,0,0
DG_F3_345,2,0,0,0,0,0,0,0,0,0,0,0,0,0,0,0,0
DG_F3_346,2,0,0,0,0,0,0,0,0,0,0,0,0,0,0,0,0
DG_F3_349,2,0,0,0,0,0,0,0,0,0,0,0,0,0,0,0,0
DG_F3_351,2,0,0,0,0,0,0,0,0,0,0,0,0,0,0,0,0
DG_F3_352,2,0,0,0,0,0,0,0,0,0,0,0,0,0,0,0,0
DG_F3_354,2,0,0,0,0,0,0,0,0,0,0,0,0,0,0,0,0
DG_F3_355,2,0,0,0,0,0,0,0,1,0,0,0,0,0,0,0,1
DG_F3_356,2,0,0,0,0,1,1,0,0,0,0,0,0,1,1,1,1
DG_F3_357,2,0,0,0,0,0,0,0,0,0,0,0,0,0,0,0,0
DG_F3_360,2,0,0,0,0,0,0,0,0,0,0,0,0,0,0,0,0
DG_F3_363,2,0,0,2,0,1,2,1,2,0,0,2,0,3,2,4,4
DG_F3_364,2,0,0,0,0,0,0,0,0,0,0,0,0,0,0,0,0
DG_F3_365,2,0,0,0,0,0,0,0,0,0,0,0,0,0,0,0,0
DG_F3_366,2,0,0,0,0,0,0,0,1,0,0,0,0,0,0,0,1
DG_F3_367,2,0,0,0,0,0,0,0,0,0,0,0,0,0,0,0,0
DG_F3_368,2,0,0,0,0,0,0,0,0,0,0,0,0,0,0,0,0
DG_F3_369,2,0,0,0,0,0,1,0,0,0,0,0,0,0,1,0,1
DG_F3_370,2,0,0,0,1,0,0,0,0,0,0,0,1,0,1,0,1
DG_F3_371,2,0,0,0,0,0,0,0,0,0,0,0,0,0,0,0,0
DG_F3_372,2,0,0,0,0,1,0,0,0,0,0,0,0,1,0,1,0
DG_F3_375,2,0,0,0,0,0,0,0,0,0,0,0,0,0,0,0,0
DG_F3_376,2,0,0,0,0,0,0,0,1,0,0,0,0,0,0,0,1
DG_F3_377,2,0,0,0,0,0,0,0,0,0,0,0,0,0,0,0,0
DG_F3_378,2,0,0,0,0,0,0,0,0,0,0,0,0,0,0,0,0
DG_F3_381,2,0,0,0,0,0,0,0,0,0,0,0,0,0,0,0,0
DG_F3_384,2,0,0,0,0,0,0,0,0,0,0,0,0,0,0,0,0
DG_F3_385,2,0,0,0,0,0,0,0,0,0,0,0,0,0,0,0,0
DG_F3_386,2,0,0,0,0,0,0,0,0,0,0,0,0,0,0,0,0
DG_F3_387,2,0,0,0,0,0,0,0,0,0,0,0,0,0,0,0,0
DG_F3_388,2,0,0,0,0,0,0,0,1,0,0,0,0,0,0,0,1
DG_F3_389,2,0,0,1,0,4,2,0,0,0,0,1,0,5,2,5,2
DG_F3_402,2,0,0,1,0,2,1,1,2,0,0,1,0,3,1,4,3
DG_F3_403,2,0,0,0,0,0,0,0,0,0,0,0,0,0,0,0,0
DG_F3_405,2,0,0,0,0,0,0,0,1,0,0,0,0,0,0,0,1
DG_F3_406,2,0,0,0,0,0,0,0,0,0,0,0,0,0,0,0,0
DG_F3_411,2,0,0,0,0,0,0,0,0,0,0,0,0,0,0,0,0
DG_F3_412,2,0,0,0,0,0,0,0,0,0,0,0,0,0,0,0,0
DG_F3_415,2,0,0,0,0,0,1,0,0,0,0,0,0,0,1,0,1
DG_F3_418,2,0,0,0,0,0,0,0,0,0,0,0,0,0,0,0,0
DG_F3_426,2,0,0,0,0,0,0,0,0,0,0,0,0,0,0,0,0
DG_F3_430,2,0,0,0,0,0,0,0,0,0,0,0,0,0,0,0,0
DG_F3_433,2,0,0,0,0,0,0,0,0,0,0,0,0,0,0,0,0
DG_F3_437,2,0,0,0,0,0,0,0,0,0,0,0,0,0,0,0,0
DG_F3_439,2,0,0,1,0,1,0,1,0,0,0,1,0,2,0,3,0
DG_F3_441,2,0,0,0,0,0,0,0,0,0,0,0,0,0,0,0,0
DG_F3_442,2,0,0,0,0,0,0,0,0,0,0,0,0,0,0,0,0
DG_F3_443,2,0,0,0,0,0,0,0,0,0,0,0,0,0,0,0,0
DG_F3_444,2,0,0,0,0,0,0,0,0,0,0,0,0,0,0,0,0
DG_F3_448,2,0,0,1,0,0,0,0,0,0,0,1,0,1,0,1,0
DG_F3_449,2,0,0,0,0,0,0,0,0,0,0,0,0,0,0,0,0
DG_F3_453,2,0,0,0,0,0,0,0,0,0,0,0,0,0,0,0,0
DG_F3_456,2,0,0,0,0,0,0,0,0,0,0,0,0,0,0,0,0
DG_F3_458,2,0,0,0,1,2,2,0,1,0,0,0,1,2,3,2,4
DG_F3_459,2,0,0,0,0,0,0,0,0,0,0,0,0,0,0,0,0
DG_F3_460,2,0,0,0,0,0,0,0,0,0,0,0,0,0,0,0,0
DG_F3_461,2,0,0,0,0,0,0,0,0,0,0,0,0,0,0,0,0
DG_F3_462,2,0,0,0,0,0,0,0,0,0,0,0,0,0,0,0,0
DG_F3_463,2,0,0,0,0,0,1,0,0,0,0,0,0,0,1,0,1
DG_F3_464,2,0,0,0,0,0,0,0,0,0,0,0,0,0,0,0,0
DG_F3_465,2,0,0,0,0,0,0,0,0,0,0,0,0,0,0,0,0
DG_F3_469,2,0,0,0,0,0,0,0,0,0,0,0,0,0,0,0,0
DG_F3_473,2,0,0,0,1,2,1,0,1,0,0,0,1,2,2,2,3
DG_F3_477,2,0,0,0,0,0,0,0,0,0,0,0,0,0,0,0,0
DG_F3_478,2,0,0,0,0,0,0,0,0,0,0,0,0,0,0,0,0
DG_F3_479,2,0,0,0,0,0,0,0,0,0,0,0,0,0,0,0,0
DG_F3_482,2,0,0,0,0,0,1,0,0,0,0,0,0,0,1,0,1
DG_F3_483,2,0,0,0,0,0,1,0,0,0,0,0,0,0,1,0,1
DG_F3_485,2,0,0,0,0,0,0,0,0,0,0,0,0,0,0,0,0
DG_F3_487,2,0,0,0,0,0,0,0,0,0,0,0,0,0,0,0,0
DG_F3_493,2,0,0,0,0,0,0,0,0,0,0,0,0,0,0,0,0
DG_F3_495,2,0,0,0,0,0,1,0,1,0,0,0,0,0,1,0,2
DG_F3_496,2,0,0,0,0,0,2,0,0,0,0,0,0,0,2,0,2
DG_F3_497,2,0,0,0,0,0,0,0,0,0,0,0,0,0,0,0,0
DG_F3_498,2,0,0,0,0,0,0,0,0,0,0,0,0,0,0,0,0
DG_F3_502,2,0,0,0,0,0,0,0,0,0,0,0,0,0,0,0,0
DG_F3_504,2,0,0,0,0,0,0,0,0,0,0,0,0,0,0,0,0
DG_F3_506,2,0,0,0,0,0,1,0,0,0,0,0,0,0,1,0,1
DG_F3_507,2,0,0,0,0,0,0,0,0,0,0,0,0,0,0,0,0
DG_F3_509,2,0,0,0,0,0,0,0,0,0,0,0,0,0,0,0,0
DG_F3_510,2,0,0,0,0,1,0,0,0,0,0,0,0,1,0,1,0
DG_F3_511,2,0,0,0,0,2,0,0,0,0,0,0,0,2,0,2,0
DG_F3_513,2,0,0,0,0,0,0,0,0,0,0,0,0,0,0,0,0
DG_F3_517,2,0,0,0,0,0,0,0,0,0,0,0,0,0,0,0,0
DG_F3_521,2,0,0,2,0,1,0,0,1,0,0,2,0,3,0,3,1
DG_F3_523,2,0,0,0,0,0,0,0,0,0,0,0,0,0,0,0,0
DG_F3_524,2,0,0,0,0,0,0,0,0,0,0,0,0,0,0,0,0
DG_F3_525,2,0,0,0,1,0,0,0,0,0,0,0,1,0,1,0,1
DG_F3_527,2,0,0,1,0,0,1,0,1,0,0,1,0,1,1,1,2
DG_F3_532,2,0,0,0,0,0,0,0,0,0,0,0,0,0,0,0,0
DG_F3_534,2,0,0,1,0,0,0,0,0,0,0,1,0,1,0,1,0
DG_F3_536,2,0,0,0,0,0,0,0,0,0,0,0,0,0,0,0,0
DG_F3_538,2,0,0,0,2,3,1,0,0,0,0,0,2,3,3,3,3
DG_F3_540,2,0,0,0,0,0,0,0,0,0,0,0,0,0,0,0,0
DG_F3_543,2,0,0,0,0,0,0,0,0,0,0,0,0,0,0,0,0
DG_F3_544,2,0,0,0,0,0,0,0,0,0,0,0,0,0,0,0,0
DG_F3_545,2,0,0,0,0,0,0,0,0,0,0,0,0,0,0,0,0
DG_F3_546,2,0,0,0,0,0,0,0,0,0,0,0,0,0,0,0,0
DG_F3_547,2,0,0,0,0,0,0,0,0,0,0,0,0,0,0,0,0
DG_F3_548,2,0,0,0,0,0,0,0,0,0,0,0,0,0,0,0,0
DG_F3_549,2,0,0,0,0,0,0,0,0,0,0,0,0,0,0,0,0
DG_F3_550,2,0,0,0,0,0,1,0,0,0,0,0,0,0,1,0,1
DG_F3_551,2,0,0,0,0,0,0,0,0,0,0,0,0,0,0,0,0
DG_F3_556,2,0,0,0,0,0,0,0,0,0,0,0,0,0,0,0,0
DG_F3_561,2,0,0,0,0,0,0,0,0,0,0,0,0,0,0,0,0
DG_F3_562,2,0,0,0,0,0,0,0,0,0,0,0,0,0,0,0,0
DG_F3_563,2,0,0,0,0,0,0,0,0,0,0,0,0,0,0,0,0
DG_F3_565,2,0,0,0,0,0,0,0,0,0,0,0,0,0,0,0,0
DG_F3_566,2,0,0,0,0,0,1,0,0,0,0,0,0,0,1,0,1
DG_F3_568,2,0,0,0,0,0,0,0,0,0,0,0,0,0,0,0,0
DG_F3_573,2,0,0,0,0,0,0,0,0,0,0,0,0,0,0,0,0
DG_F3_581,2,0,0,0,0,0,1,0,0,0,0,0,0,0,1,0,1
DG_F3_582,2,0,0,0,0,0,0,0,0,0,0,0,0,0,0,0,0
DG_F3_585,2,0,0,0,0,0,1,0,0,0,0,0,0,0,1,0,1
DG_F3_589,2,0,0,0,0,0,0,0,0,0,0,0,0,0,0,0,0
DG_F3_592,2,0,0,0,1,0,0,0,0,0,0,0,1,0,1,0,1
DG_F3_594,2,0,0,0,0,0,0,0,0,0,0,0,0,0,0,0,0
DG_F3_595,2,0,0,0,0,0,0,0,0,0,0,0,0,0,0,0,0
DG_F3_598,2,0,0,0,0,0,0,0,0,0,0,0,0,0,0,0,0
DG_F3_602,2,0,0,0,0,0,0,1,0,0,0,0,0,0,0,1,0
DG_F3_604,2,0,0,0,0,0,0,0,0,0,0,0,0,0,0,0,0
DG_F3_606,2,0,0,0,0,0,0,0,0,0,0,0,0,0,0,0,0
DG_F3_607,2,0,0,0,0,0,0,0,0,0,0,0,0,0,0,0,0
DG_F3_608,2,0,0,0,0,0,0,0,0,0,0,0,0,0,0,0,0
DG_F3_609,2,0,0,0,0,0,0,0,0,0,0,0,0,0,0,0,0
DG_F3_610,2,0,0,0,0,0,0,0,0,0,0,0,0,0,0,0,0
DG_F3_611,2,0,0,0,0,2,0,0,0,0,0,0,0,2,0,2,0
DG_F3_612,2,0,0,0,0,0,0,0,0,0,0,0,0,0,0,0,0
DG_F3_613,2,0,0,0,0,0,0,0,0,0,0,0,0,0,0,0,0
DG_F3_614,2,0,0,0,0,0,0,0,0,0,0,0,0,0,0,0,0
DG_F3_617,2,0,0,0,0,1,0,0,0,0,0,0,0,1,0,1,0
DG_F3_618,2,0,0,0,0,0,0,0,0,0,0,0,0,0,0,0,0
DG_F3_619,2,0,0,0,0,0,0,0,0,0,0,0,0,0,0,0,0
DG_F3_620,2,0,0,0,0,0,0,0,0,0,0,0,0,0,0,0,0
DG_F3_621,2,0,0,0,0,0,0,2,0,0,0,0,0,0,0,2,0
DG_F3_624,2,0,0,0,1,1,0,0,0,0,0,0,1,1,1,1,1
DG_F3_628,2,0,0,1,0,0,0,0,0,0,0,1,0,1,0,1,0
DG_F3_630,2,0,0,0,0,0,0,0,0,0,0,0,0,0,0,0,0
DG_F3_632,2,0,0,0,0,0,0,0,0,0,0,0,0,0,0,0,0
DG_F3_633,2,0,0,0,0,0,0,0,0,0,0,0,0,0,0,0,0
DG_F3_634,2,0,0,0,0,0,0,0,0,0,0,0,0,0,0,0,0
DG_F3_635,2,0,0,0,0,0,0,0,0,0,0,0,0,0,0,0,0
DG_F3_636,2,0,0,0,0,1,0,1,0,0,0,0,0,1,0,2,0
DG_F3_638,2,0,0,0,0,0,0,0,0,0,0,0,0,0,0,0,0
DG_F3_639,2,0,0,0,0,0,0,0,0,0,0,0,0,0,0,0,0
DG_F3_640,2,0,0,0,0,0,0,1,0,0,0,0,0,0,0,1,0
DG_F3_641,2,0,0,0,0,0,0,0,0,0,0,0,0,0,0,0,0
DG_F3_642,2,0,0,0,0,0,0,0,0,0,0,0,0,0,0,0,0
DG_F3_643,2,0,0,0,0,0,0,0,0,0,0,0,0,0,0,0,0
DG_F3_644,2,0,0,0,0,0,0,0,0,0,0,0,0,0,0,0,0
DG_F3_004,3,0,0,0,0,0,0,0,0,0,0,0,0,0,0,0,0
DG_F3_007,3,0,0,0,0,0,0,0,0,0,0,0,0,0,0,0,0
DG_F3_008,3,0,0,0,0,0,0,1,0,0,0,0,0,0,0,1,0
DG_F3_009,3,0,0,0,0,0,0,0,0,0,0,0,0,0,0,0,0
DG_F3_011,3,0,0,0,0,0,0,0,0,0,0,0,0,0,0,0,0
DG_F3_013,3,0,0,0,0,0,0,0,0,0,0,0,0,0,0,0,0
DG_F3_015,3,0,0,0,0,0,0,3,1,0,0,0,0,0,0,3,1
DG_F3_017,3,0,0,0,0,0,0,0,1,0,0,0,0,0,0,0,1
DG_F3_019,3,0,0,0,0,0,0,0,0,0,0,0,0,0,0,0,0
DG_F3_020,3,0,0,0,0,1,3,1,0,0,0,0,0,1,3,2,3
DG_F3_022,3,0,0,0,0,2,0,0,0,0,0,0,0,2,0,2,0
DG_F3_024,3,0,0,0,0,0,0,0,0,0,0,0,0,0,0,0,0
DG_F3_028,3,0,0,0,0,2,1,1,0,0,0,0,0,2,1,3,1
DG_F3_032,3,0,0,0,0,2,0,1,1,0,0,0,0,2,0,3,1
DG_F3_033,3,0,0,0,0,0,0,0,0,0,0,0,0,0,0,0,0
DG_F3_038,3,0,1,1,0,0,0,1,0,0,1,1,1,1,1,2,1
DG_F3_040,3,0,0,0,0,0,0,0,0,0,0,0,0,0,0,0,0
DG_F3_042,3,0,0,0,0,0,0,0,0,0,0,0,0,0,0,0,0
DG_F3_049,3,0,0,0,0,0,0,0,0,0,0,0,0,0,0,0,0
DG_F3_051,3,0,0,0,0,0,0,0,0,0,0,0,0,0,0,0,0
DG_F3_054,3,0,0,0,0,0,0,0,0,0,0,0,0,0,0,0,0
DG_F3_056,3,0,0,0,0,0,0,0,0,0,0,0,0,0,0,0,0
DG_F3_057,3,0,0,1,0,3,0,1,1,0,0,1,0,4,0,5,1
DG_F3_059,3,0,0,0,0,1,0,0,0,0,0,0,0,1,0,1,0
DG_F3_063,3,0,0,0,0,0,0,0,0,0,0,0,0,0,0,0,0
DG_F3_066,3,0,0,0,0,0,0,0,0,0,0,0,0,0,0,0,0
DG_F3_068,3,0,0,0,0,0,0,0,0,0,0,0,0,0,0,0,0
DG_F3_069,3,0,0,0,0,0,1,1,0,0,0,0,0,0,1,1,1
DG_F3_070,3,0,0,0,1,0,1,0,1,0,0,0,1,0,2,0,3
DG_F3_075,3,0,0,0,0,0,0,0,0,0,0,0,0,0,0,0,0
DG_F3_076,3,0,0,0,0,0,0,0,0,0,0,0,0,0,0,0,0
DG_F3_077,3,0,0,0,0,0,0,0,0,0,0,0,0,0,0,0,0
DG_F3_081,3,0,0,0,0,0,0,0,0,0,0,0,0,0,0,0,0
DG_F3_082,3,0,0,0,0,0,0,0,0,0,0,0,0,0,0,0,0
DG_F3_085,3,0,0,0,0,0,0,0,0,0,0,0,0,0,0,0,0
DG_F3_088,3,0,0,0,0,0,0,0,0,0,0,0,0,0,0,0,0
DG_F3_090,3,0,0,0,0,0,0,0,0,0,0,0,0,0,0,0,0
DG_F3_092,3,0,0,0,0,0,0,0,0,0,0,0,0,0,0,0,0
DG_F3_093,3,0,0,0,0,0,0,0,0,0,0,0,0,0,0,0,0
DG_F3_094,3,0,0,0,0,0,0,1,0,0,0,0,0,0,0,1,0
DG_F3_095,3,0,0,0,0,0,0,0,0,0,0,0,0,0,0,0,0
DG_F3_096,3,0,0,0,0,3,0,0,0,0,0,0,0,3,0,3,0
DG_F3_097,3,0,0,0,0,0,0,0,0,0,0,0,0,0,0,0,0
DG_F3_098,3,0,0,0,0,0,0,2,0,0,0,0,0,0,0,2,0
DG_F3_099,3,0,0,0,0,0,0,0,0,0,0,0,0,0,0,0,0
DG_F3_101,3,0,0,1,0,0,0,0,3,0,0,1,0,1,0,1,3
DG_F3_102,3,0,0,0,0,0,0,0,0,0,0,0,0,0,0,0,0
DG_F3_103,3,0,0,0,0,0,0,0,0,0,0,0,0,0,0,0,0
DG_F3_106,3,0,0,0,0,1,0,0,0,0,0,0,0,1,0,1,0
DG_F3_107,3,0,0,0,0,0,0,0,0,0,0,0,0,0,0,0,0
DG_F3_115,3,0,0,0,0,0,0,0,0,0,0,0,0,0,0,0,0
DG_F3_118,3,0,0,0,0,0,0,0,0,0,0,0,0,0,0,0,0
DG_F3_119,3,0,0,0,0,0,0,0,0,0,0,0,0,0,0,0,0
DG_F3_120,3,0,0,0,0,0,0,0,0,0,0,0,0,0,0,0,0
DG_F3_121,3,0,0,0,0,0,0,0,0,0,0,0,0,0,0,0,0
DG_F3_124,3,0,0,0,0,0,0,0,0,0,0,0,0,0,0,0,0
DG_F3_126,3,0,0,0,0,0,0,0,0,0,0,0,0,0,0,0,0
DG_F3_127,3,0,0,0,0,0,0,0,0,0,0,0,0,0,0,0,0
DG_F3_129,3,0,0,0,0,0,0,0,0,0,0,0,0,0,0,0,0
DG_F3_131,3,0,0,0,0,0,0,0,2,0,0,0,0,0,0,0,2
DG_F3_132,3,0,0,0,0,1,1,2,3,0,0,0,0,1,1,3,4
DG_F3_133,3,1,0,0,0,3,0,0,0,1,0,1,0,4,0,4,0
DG_F3_136,3,0,0,0,0,1,0,1,1,0,0,0,0,1,0,2,1
DG_F3_139,3,0,0,0,0,0,1,0,0,0,0,0,0,0,1,0,1
DG_F3_145,3,0,0,0,0,0,0,0,0,0,0,0,0,0,0,0,0
DG_F3_150,3,0,0,1,0,1,1,1,1,0,0,1,0,2,1,3,2
DG_F3_152,3,0,0,0,0,0,0,0,0,0,0,0,0,0,0,0,0
DG_F3_154,3,0,0,0,0,0,1,0,0,0,0,0,0,0,1,0,1
DG_F3_157,3,0,0,0,0,0,0,0,0,0,0,0,0,0,0,0,0
DG_F3_159,3,0,0,0,0,0,0,0,0,0,0,0,0,0,0,0,0
DG_F3_163,3,0,0,0,0,0,0,0,0,0,0,0,0,0,0,0,0
DG_F3_164,3,0,0,0,0,0,0,0,0,0,0,0,0,0,0,0,0
DG_F3_165,3,0,0,0,0,0,0,0,0,0,0,0,0,0,0,0,0
DG_F3_167,3,0,0,0,0,0,0,0,0,0,0,0,0,0,0,0,0
DG_F3_175,3,0,0,0,0,0,0,0,0,0,0,0,0,0,0,0,0
DG_F3_179,3,0,0,0,0,0,0,0,0,0,0,0,0,0,0,0,0
DG_F3_180,3,0,0,0,0,0,0,0,0,0,0,0,0,0,0,0,0
DG_F3_185,3,0,0,0,0,0,0,0,0,0,0,0,0,0,0,0,0
DG_F3_190,3,0,0,0,0,0,0,0,2,0,0,0,0,0,0,0,2
DG_F3_194,3,0,0,0,0,0,1,0,0,0,0,0,0,0,1,0,1
DG_F3_195,3,0,0,0,0,0,0,0,0,0,0,0,0,0,0,0,0
DG_F3_196,3,0,0,0,0,0,0,0,0,0,0,0,0,0,0,0,0
DG_F3_200,3,0,0,0,0,0,0,0,0,0,0,0,0,0,0,0,0
DG_F3_203,3,0,0,0,0,0,0,0,0,0,0,0,0,0,0,0,0
DG_F3_210,3,0,0,0,0,0,0,0,0,0,0,0,0,0,0,0,0
DG_F3_212,3,0,0,0,0,0,1,0,1,0,0,0,0,0,1,0,2
DG_F3_214,3,0,0,0,0,0,0,0,0,0,0,0,0,0,0,0,0
DG_F3_218,3,0,0,0,0,0,0,0,0,0,0,0,0,0,0,0,0
DG_F3_220,3,0,0,0,0,0,0,0,0,0,0,0,0,0,0,0,0
DG_F3_223,3,0,0,0,0,1,3,2,1,0,0,0,0,1,3,3,4
DG_F3_225,3,0,0,0,0,0,0,0,0,0,0,0,0,0,0,0,0
DG_F3_227,3,0,0,0,0,0,0,0,0,0,0,0,0,0,0,0,0
DG_F3_230,3,0,0,0,0,0,0,0,0,0,0,0,0,0,0,0,0
DG_F3_231,3,0,0,0,0,0,1,0,0,0,0,0,0,0,1,0,1
DG_F3_232,3,0,0,0,0,0,0,0,0,0,0,0,0,0,0,0,0
DG_F3_236,3,0,0,0,0,0,0,0,0,0,0,0,0,0,0,0,0
DG_F3_239,3,0,0,0,0,0,0,0,0,0,0,0,0,0,0,0,0
DG_F3_241,3,0,0,0,0,0,0,0,0,0,0,0,0,0,0,0,0
DG_F3_245,3,0,0,0,0,0,0,0,0,0,0,0,0,0,0,0,0
DG_F3_246,3,0,0,0,0,0,2,0,0,0,0,0,0,0,2,0,2
DG_F3_247,3,0,0,0,0,0,0,0,0,0,0,0,0,0,0,0,0
DG_F3_248,3,0,0,0,0,0,0,2,0,0,0,0,0,0,0,2,0
DG_F3_249,3,0,0,0,0,0,1,0,0,0,0,0,0,0,1,0,1
DG_F3_250,3,0,0,1,0,4,2,0,2,0,0,1,0,5,2,5,4
DG_F3_255,3,0,0,0,0,0,0,0,0,0,0,0,0,0,0,0,0
DG_F3_257,3,0,0,0,0,0,0,0,0,0,0,0,0,0,0,0,0
DG_F3_263,3,0,0,0,0,0,0,0,0,0,0,0,0,0,0,0,0
DG_F3_266,3,0,0,0,0,0,1,0,0,0,0,0,0,0,1,0,1
DG_F3_269,3,0,0,0,1,0,0,0,0,0,0,0,1,0,1,0,1
DG_F3_270,3,0,0,0,0,0,0,0,0,0,0,0,0,0,0,0,0
DG_F3_271,3,0,0,1,0,0,1,0,0,0,0,1,0,1,1,1,1
DG_F3_273,3,0,0,2,0,1,0,1,0,0,0,2,0,3,0,4,0
DG_F3_274,3,0,0,0,1,0,0,0,0,0,0,0,1,0,1,0,1
DG_F3_276,3,0,0,0,0,0,0,0,0,0,0,0,0,0,0,0,0
DG_F3_280,3,0,0,0,0,0,0,0,0,0,0,0,0,0,0,0,0
DG_F3_283,3,0,0,0,0,0,0,0,0,0,0,0,0,0,0,0,0
DG_F3_285,3,0,0,0,0,0,0,0,0,0,0,0,0,0,0,0,0
DG_F3_286,3,0,0,0,0,0,0,0,0,0,0,0,0,0,0,0,0
DG_F3_287,3,0,0,0,1,0,4,0,0,0,0,0,1,0,5,0,5
DG_F3_292,3,0,0,0,0,0,0,0,0,0,0,0,0,0,0,0,0
DG_F3_293,3,0,0,0,0,0,0,0,0,0,0,0,0,0,0,0,0
DG_F3_294,3,0,0,0,0,0,0,0,0,0,0,0,0,0,0,0,0
DG_F3_297,3,0,0,0,0,0,0,0,0,0,0,0,0,0,0,0,0
DG_F3_298,3,0,0,0,0,0,0,0,0,0,0,0,0,0,0,0,0
DG_F3_299,3,0,0,0,0,0,0,0,0,0,0,0,0,0,0,0,0
DG_F3_300,3,0,0,0,0,0,1,0,0,0,0,0,0,0,1,0,1
DG_F3_302,3,0,0,0,0,0,0,0,0,0,0,0,0,0,0,0,0
DG_F3_304,3,0,0,0,0,0,0,0,0,0,0,0,0,0,0,0,0
DG_F3_305,3,0,0,0,1,0,0,0,2,0,0,0,1,0,1,0,3
DG_F3_307,3,0,0,0,1,0,0,0,0,0,0,0,1,0,1,0,1
DG_F3_309,3,0,0,0,0,0,1,0,0,0,0,0,0,0,1,0,1
DG_F3_312,3,0,0,1,1,0,0,1,1,0,0,1,1,1,1,2,2
DG_F3_315,3,0,0,0,0,0,0,0,0,0,0,0,0,0,0,0,0
DG_F3_316,3,0,0,0,0,1,3,0,0,0,0,0,0,1,3,1,3
DG_F3_317,3,0,0,0,0,0,0,0,0,0,0,0,0,0,0,0,0
DG_F3_318,3,0,0,0,0,0,0,0,0,0,0,0,0,0,0,0,0
DG_F3_324,3,0,0,1,0,0,3,0,0,0,0,1,0,1,3,1,3
DG_F3_325,3,0,0,0,0,1,6,0,4,0,0,0,0,1,6,1,10
DG_F3_328,3,0,0,0,0,1,0,1,0,0,0,0,0,1,0,2,0
DG_F3_329,3,0,0,0,0,0,0,0,0,0,0,0,0,0,0,0,0
DG_F3_330,3,0,0,0,0,0,0,0,0,0,0,0,0,0,0,0,0
DG_F3_331,3,0,0,0,0,0,0,0,0,0,0,0,0,0,0,0,0
DG_F3_332,3,0,0,0,0,2,0,0,0,0,0,0,0,2,0,2,0
DG_F3_333,3,0,0,0,0,2,1,1,0,0,0,0,0,2,1,3,1
DG_F3_334,3,0,0,0,0,0,0,0,0,0,0,0,0,0,0,0,0
DG_F3_335,3,0,0,0,0,0,0,0,0,0,0,0,0,0,0,0,0
DG_F3_336,3,0,0,0,0,0,1,1,0,0,0,0,0,0,1,1,1
DG_F3_337,3,0,0,0,0,0,0,0,0,0,0,0,0,0,0,0,0
DG_F3_338,3,0,0,2,0,2,1,0,0,0,0,2,0,4,1,4,1
DG_F3_342,3,1,0,0,2,1,1,3,1,1,0,1,2,2,3,5,4
DG_F3_344,4,0,0,0,0,0,0,0,0,0,0,0,0,0,0,0,0
DG_F3_345,4,0,0,0,0,0,0,0,0,0,0,0,0,0,0,0,0
DG_F3_346,4,0,0,0,0,0,0,0,0,0,0,0,0,0,0,0,0
DG_F3_349,4,0,0,0,0,0,0,0,0,0,0,0,0,0,0,0,0
DG_F3_351,4,0,0,0,0,0,0,0,0,0,0,0,0,0,0,0,0
DG_F3_352,4,0,0,0,0,0,1,0,0,0,0,0,0,0,1,0,1
DG_F3_354,4,0,0,0,0,1,0,0,1,0,0,0,0,1,0,1,1
DG_F3_355,4,0,0,1,1,0,1,0,1,0,0,1,1,1,2,1,3
DG_F3_356,4,0,0,0,1,0,2,0,2,0,0,0,1,0,3,0,5
DG_F3_357,4,0,0,2,0,0,0,0,1,0,0,2,0,2,0,2,1
DG_F3_360,4,0,0,0,0,1,0,0,0,0,0,0,0,1,0,1,0
DG_F3_363,4,0,0,1,2,1,3,0,6,0,0,1,2,2,5,2,11
DG_F3_364,4,0,0,1,0,1,1,0,0,0,0,1,0,2,1,2,1
DG_F3_365,4,0,0,0,0,1,0,0,3,0,0,0,0,1,0,1,3
DG_F3_366,4,0,0,0,0,0,0,0,1,0,0,0,0,0,0,0,1
DG_F3_367,4,0,0,2,0,0,0,0,0,0,0,2,0,2,0,2,0
DG_F3_368,4,0,0,0,0,0,0,0,0,0,0,0,0,0,0,0,0
DG_F3_369,4,0,0,0,0,1,0,0,0,0,0,0,0,1,0,1,0
DG_F3_370,4,0,0,0,0,0,1,0,0,0,0,0,0,0,1,0,1
DG_F3_371,4,0,0,0,0,0,0,0,2,0,0,0,0,0,0,0,2
DG_F3_372,4,0,0,0,1,0,0,0,2,0,0,0,1,0,1,0,3
DG_F3_375,4,0,0,1,0,0,2,1,1,0,0,1,0,1,2,2,3
DG_F3_376,4,0,0,1,0,0,2,0,2,0,0,1,0,1,2,1,4
DG_F3_377,4,0,0,0,0,0,0,0,0,0,0,0,0,0,0,0,0
DG_F3_378,4,0,0,0,0,0,0,0,0,0,0,0,0,0,0,0,0
DG_F3_381,4,0,0,0,0,0,0,4,2,0,0,0,0,0,0,4,2
DG_F3_384,4,0,0,0,0,0,0,0,0,0,0,0,0,0,0,0,0
DG_F3_385,4,0,0,0,0,0,0,0,0,0,0,0,0,0,0,0,0
DG_F3_386,4,0,0,0,0,0,0,0,0,0,0,0,0,0,0,0,0
DG_F3_387,4,0,0,0,0,0,0,0,0,0,0,0,0,0,0,0,0
DG_F3_388,4,0,0,0,0,1,0,1,0,0,0,0,0,1,0,2,0
DG_F3_389,4,0,0,1,1,0,0,5,1,0,0,1,1,1,1,6,2
DG_F3_402,4,0,0,0,0,1,0,1,0,0,0,0,0,1,0,2,0
DG_F3_403,4,0,0,0,0,0,0,1,0,0,0,0,0,0,0,1,0
DG_F3_405,4,0,0,0,0,1,0,0,1,0,0,0,0,1,0,1,1
DG_F3_406,4,0,0,0,0,1,2,2,1,0,0,0,0,1,2,3,3
DG_F3_411,4,0,0,0,0,0,0,0,0,0,0,0,0,0,0,0,0
DG_F3_412,4,0,0,0,0,0,0,0,0,0,0,0,0,0,0,0,0
DG_F3_415,4,0,0,0,0,1,0,1,0,0,0,0,0,1,0,2,0
DG_F3_418,4,0,0,0,0,0,0,1,0,0,0,0,0,0,0,1,0
DG_F3_426,4,0,0,0,0,0,0,1,0,0,0,0,0,0,0,1,0
DG_F3_430,4,0,0,0,0,0,0,0,0,0,0,0,0,0,0,0,0
DG_F3_433,4,0,0,0,1,0,0,1,1,0,0,0,1,0,1,1,2
DG_F3_437,4,0,0,0,0,0,0,0,1,0,0,0,0,0,0,0,1
DG_F3_439,4,0,0,0,0,0,0,1,0,0,0,0,0,0,0,1,0
DG_F3_441,4,0,0,0,0,0,0,0,0,0,0,0,0,0,0,0,0
DG_F3_442,4,0,0,0,0,0,0,0,0,0,0,0,0,0,0,0,0
DG_F3_443,4,0,0,0,0,0,0,0,2,0,0,0,0,0,0,0,2
DG_F3_444,4,0,0,0,0,0,0,0,0,0,0,0,0,0,0,0,0
DG_F3_448,4,0,0,0,0,0,0,2,2,0,0,0,0,0,0,2,2
DG_F3_449,4,0,0,0,0,0,0,0,0,0,0,0,0,0,0,0,0
DG_F3_453,4,0,0,0,0,0,0,0,0,0,0,0,0,0,0,0,0
DG_F3_456,4,0,0,0,0,0,0,0,0,0,0,0,0,0,0,0,0
DG_F3_458,4,0,0,0,3,1,0,5,4,0,0,0,3,1,3,6,7
DG_F3_459,4,0,0,0,0,0,0,1,0,0,0,0,0,0,0,1,0
DG_F3_460,4,0,0,0,0,0,0,3,3,0,0,0,0,0,0,3,3
DG_F3_461,4,0,0,0,0,0,0,0,0,0,0,0,0,0,0,0,0
DG_F3_462,4,0,0,0,0,0,0,0,0,0,0,0,0,0,0,0,0
DG_F3_463,4,0,0,0,0,1,1,4,1,0,0,0,0,1,1,5,2
DG_F3_464,4,0,0,0,0,1,1,4,0,0,0,0,0,1,1,5,1
DG_F3_465,4,0,0,0,0,0,0,0,0,0,0,0,0,0,0,0,0
DG_F3_469,4,0,0,0,0,0,0,0,0,0,0,0,0,0,0,0,0
DG_F3_473,4,0,0,0,0,1,1,2,7,0,0,0,0,1,1,3,8
DG_F3_477,4,0,0,0,0,0,0,0,0,0,0,0,0,0,0,0,0
DG_F3_478,4,0,0,0,0,3,0,2,3,0,0,0,0,3,0,5,3
DG_F3_479,4,0,0,0,0,0,0,0,0,0,0,0,0,0,0,0,0
DG_F3_482,4,0,0,0,0,0,0,0,0,0,0,0,0,0,0,0,0
DG_F3_483,4,0,0,0,0,0,0,1,3,0,0,0,0,0,0,1,3
DG_F3_485,4,0,0,0,0,0,0,0,0,0,0,0,0,0,0,0,0
DG_F3_487,4,0,0,0,0,0,0,0,0,0,0,0,0,0,0,0,0
DG_F3_493,4,0,0,0,0,0,0,0,0,0,0,0,0,0,0,0,0
DG_F3_495,4,0,0,0,0,0,0,0,0,0,0,0,0,0,0,0,0
DG_F3_496,4,0,0,0,0,0,0,0,0,0,0,0,0,0,0,0,0
DG_F3_497,4,0,0,0,0,0,0,0,0,0,0,0,0,0,0,0,0
DG_F3_498,4,0,0,0,0,0,0,0,0,0,0,0,0,0,0,0,0
DG_F3_502,4,0,0,0,0,0,0,1,0,0,0,0,0,0,0,1,0
DG_F3_504,4,0,0,0,0,0,0,0,0,0,0,0,0,0,0,0,0
DG_F3_506,4,0,0,0,0,0,0,1,0,0,0,0,0,0,0,1,0
DG_F3_507,4,0,0,0,0,0,0,0,0,0,0,0,0,0,0,0,0
DG_F3_509,4,0,0,0,0,0,0,3,0,0,0,0,0,0,0,3,0
DG_F3_510,4,0,0,0,0,0,0,1,4,0,0,0,0,0,0,1,4
DG_F3_511,4,0,0,0,1,0,1,5,4,0,0,0,1,0,2,5,6
DG_F3_513,4,0,0,0,0,0,0,3,1,0,0,0,0,0,0,3,1
DG_F3_517,4,0,0,0,0,0,0,1,1,0,0,0,0,0,0,1,1
DG_F3_521,4,0,0,1,0,2,0,1,0,0,0,1,0,3,0,4,0
DG_F3_523,4,0,0,0,0,0,0,0,0,0,0,0,0,0,0,0,0
DG_F3_524,4,0,0,0,0,0,0,1,2,0,0,0,0,0,0,1,2
DG_F3_525,4,0,0,0,0,2,0,0,4,0,0,0,0,2,0,2,4
DG_F3_527,4,0,0,0,0,0,0,0,0,0,0,0,0,0,0,0,0
DG_F3_532,4,0,0,0,0,0,0,0,0,0,0,0,0,0,0,0,0
DG_F3_534,4,0,0,0,0,2,1,7,0,0,0,0,0,2,1,9,1
DG_F3_536,4,0,0,0,0,0,0,0,0,0,0,0,0,0,0,0,0
DG_F3_538,4,0,0,2,2,3,3,7,2,0,0,2,2,5,5,12,7
DG_F3_540,4,0,0,0,0,0,0,1,0,0,0,0,0,0,0,1,0
DG_F3_543,4,0,0,0,0,0,0,0,0,0,0,0,0,0,0,0,0
DG_F3_544,4,0,0,0,0,0,0,2,1,0,0,0,0,0,0,2,1
DG_F3_545,4,0,0,0,0,0,0,0,0,0,0,0,0,0,0,0,0
DG_F3_546,4,0,0,0,0,0,0,5,0,0,0,0,0,0,0,5,0
DG_F3_547,4,0,0,0,1,0,0,1,0,0,0,0,1,0,1,1,1
DG_F3_548,4,0,0,1,2,0,1,2,0,0,0,1,2,1,3,3,3
DG_F3_549,4,0,0,0,0,0,0,0,0,0,0,0,0,0,0,0,0
DG_F3_550,4,0,0,3,0,1,1,0,1,0,0,3,0,4,1,4,2
DG_F3_551,4,0,0,0,0,0,0,0,0,0,0,0,0,0,0,0,0
DG_F3_556,4,0,0,0,0,0,0,0,0,0,0,0,0,0,0,0,0
DG_F3_561,4,0,0,0,0,0,0,0,0,0,0,0,0,0,0,0,0
DG_F3_562,4,0,0,0,0,0,0,0,0,0,0,0,0,0,0,0,0
DG_F3_563,4,0,0,0,0,0,0,0,0,0,0,0,0,0,0,0,0
DG_F3_565,4,0,0,0,0,0,1,2,3,0,0,0,0,0,1,2,4
DG_F3_566,4,0,0,0,0,0,0,0,1,0,0,0,0,0,0,0,1
DG_F3_568,4,0,0,0,0,0,0,0,0,0,0,0,0,0,0,0,0
DG_F3_573,4,0,0,1,1,0,0,4,0,0,0,1,1,1,1,5,1
DG_F3_581,4,0,0,0,0,0,0,2,2,0,0,0,0,0,0,2,2
DG_F3_582,4,0,0,0,0,0,0,1,1,0,0,0,0,0,0,1,1
DG_F3_585,4,0,0,1,2,0,1,3,4,0,0,1,2,1,3,4,7
DG_F3_589,4,0,0,0,0,0,0,0,0,0,0,0,0,0,0,0,0
DG_F3_592,4,0,0,0,0,0,0,1,3,0,0,0,0,0,0,1,3
DG_F3_594,4,0,0,0,0,0,0,0,0,0,0,0,0,0,0,0,0
DG_F3_595,4,0,0,0,0,0,0,0,0,0,0,0,0,0,0,0,0
DG_F3_598,4,0,0,0,0,0,0,0,0,0,0,0,0,0,0,0,0
DG_F3_602,4,0,0,0,0,0,0,0,0,0,0,0,0,0,0,0,0
DG_F3_604,4,0,0,0,0,0,1,3,4,0,0,0,0,0,1,3,5
DG_F3_606,4,0,0,0,0,0,0,4,0,0,0,0,0,0,0,4,0
DG_F3_607,4,0,0,0,1,0,1,3,2,0,0,0,1,0,2,3,4
DG_F3_608,4,0,0,0,0,0,0,0,0,0,0,0,0,0,0,0,0
DG_F3_609,4,0,0,0,0,0,0,0,0,0,0,0,0,0,0,0,0
DG_F3_610,4,0,0,0,0,0,0,0,2,0,0,0,0,0,0,0,2
DG_F3_611,4,0,0,0,0,0,0,2,0,0,0,0,0,0,0,2,0
DG_F3_612,4,0,0,0,2,0,0,3,5,0,0,0,2,0,2,3,7
DG_F3_613,4,0,0,0,0,0,0,0,0,0,0,0,0,0,0,0,0
DG_F3_614,4,0,0,0,0,0,0,1,0,0,0,0,0,0,0,1,0
DG_F3_617,4,0,0,1,1,2,3,2,4,0,0,1,1,3,4,5,8
DG_F3_618,4,0,0,0,0,0,0,0,0,0,0,0,0,0,0,0,0
DG_F3_619,4,0,0,0,0,0,0,0,0,0,0,0,0,0,0,0,0
DG_F3_620,4,0,0,0,0,0,0,1,1,0,0,0,0,0,0,1,1
DG_F3_621,4,0,0,0,1,0,0,3,2,0,0,0,1,0,1,3,3
DG_F3_624,4,0,0,0,0,0,2,4,0,0,0,0,0,0,2,4,2
DG_F3_628,4,0,0,0,0,1,1,3,1,0,0,0,0,1,1,4,2
DG_F3_630,4,0,0,0,0,0,0,0,1,0,0,0,0,0,0,0,1
DG_F3_632,4,0,0,0,0,0,0,0,0,0,0,0,0,0,0,0,0
DG_F3_633,4,0,0,0,0,0,0,2,1,0,0,0,0,0,0,2,1
DG_F3_634,4,0,0,0,0,0,0,0,0,0,0,0,0,0,0,0,0
DG_F3_635,4,0,0,0,0,0,0,1,2,0,0,0,0,0,0,1,2
DG_F3_636,4,0,0,1,0,0,0,1,2,0,0,1,0,1,0,2,2
DG_F3_638,4,0,0,0,0,0,0,0,0,0,0,0,0,0,0,0,0
DG_F3_639,4,0,0,0,0,0,0,0,0,0,0,0,0,0,0,0,0
DG_F3_640,4,0,0,0,0,0,0,0,2,0,0,0,0,0,0,0,2
DG_F3_641,4,0,0,0,0,0,0,0,0,0,0,0,0,0,0,0,0
DG_F3_642,4,0,0,0,0,0,0,0,0,0,0,0,0,0,0,0,0
DG_F3_643,4,0,0,0,0,0,0,0,0,0,0,0,0,0,0,0,0
DG_F3_644,4,0,0,0,0,0,0,2,0,0,0,0,0,0,0,2,0
DG_F3_004,5,0,0,1,1,0,0,2,0,0,0,1,1,1,1,3,1
DG_F3_007,5,0,0,1,1,0,3,6,2,0,0,1,1,1,4,7,6
DG_F3_008,5,0,0,0,0,2,0,3,3,0,0,0,0,2,0,5,3
DG_F3_009,5,0,0,1,1,0,1,5,1,0,0,1,1,1,2,6,3
DG_F3_011,5,0,0,0,0,1,2,1,0,0,0,0,0,1,2,2,2
DG_F3_013,5,0,0,0,2,0,2,3,1,0,0,0,2,0,4,3,5
DG_F3_015,5,0,0,2,3,2,3,6,0,0,0,2,3,4,6,10,6
DG_F3_017,5,0,0,4,1,1,4,6,2,0,0,4,1,5,5,11,7
DG_F3_019,5,0,0,2,2,0,1,7,2,0,0,2,2,2,3,9,5
DG_F3_020,5,0,0,0,2,1,3,9,1,0,0,0,2,1,5,10,6
DG_F3_022,5,0,0,2,0,0,1,4,0,0,0,2,0,2,1,6,1
DG_F3_024,5,0,0,0,0,1,5,5,1,0,0,0,0,1,5,6,6
DG_F3_028,5,0,0,2,3,4,3,8,3,0,0,2,3,6,6,14,9
DG_F3_032,5,0,0,2,2,2,1,5,2,0,0,2,2,4,3,9,5
DG_F3_033,5,0,0,0,0,0,0,0,0,0,0,0,0,0,0,0,0
DG_F3_038,5,0,0,2,2,3,1,1,1,0,0,2,2,5,3,6,4
DG_F3_040,5,0,0,5,3,3,4,6,1,0,0,5,3,8,7,14,8
DG_F3_042,5,0,0,1,2,4,3,7,3,0,0,1,2,5,5,12,8
DG_F3_049,5,0,0,0,0,0,0,1,0,0,0,0,0,0,0,1,0
DG_F3_051,5,0,0,0,0,1,2,2,0,0,0,0,0,1,2,3,2
DG_F3_054,5,0,0,2,1,3,5,7,0,0,0,2,1,5,6,12,6
DG_F3_056,5,0,0,0,0,0,1,0,0,0,0,0,0,0,1,0,1
DG_F3_057,5,0,0,4,3,4,1,4,4,0,0,4,3,8,4,12,8
DG_F3_059,5,0,0,0,2,0,3,1,1,0,0,0,2,0,5,1,6
DG_F3_063,5,0,0,0,0,0,0,0,0,0,0,0,0,0,0,0,0
DG_F3_066,5,0,0,0,0,0,0,0,0,0,0,0,0,0,0,0,0
DG_F3_068,5,0,0,0,1,0,5,3,2,0,0,0,1,0,6,3,8
DG_F3_069,5,0,0,3,2,0,2,3,1,0,0,3,2,3,4,6,5
DG_F3_070,5,0,0,2,0,1,2,5,2,0,0,2,0,3,2,8,4
DG_F3_075,5,0,0,0,0,0,0,1,0,0,0,0,0,0,0,1,0
DG_F3_076,5,0,0,1,0,0,0,0,0,0,0,1,0,1,0,1,0
DG_F3_077,5,0,0,1,0,0,2,0,0,0,0,1,0,1,2,1,2
DG_F3_081,5,0,0,0,0,2,1,3,1,0,0,0,0,2,1,5,2
DG_F3_082,5,0,0,0,0,0,0,0,0,0,0,0,0,0,0,0,0
DG_F3_085,5,0,0,1,1,0,2,0,1,0,0,1,1,1,3,1,4
DG_F3_088,5,0,0,0,0,0,0,0,0,0,0,0,0,0,0,0,0
DG_F3_090,5,0,0,0,2,1,0,2,2,0,0,0,2,1,2,3,4
DG_F3_092,5,0,0,0,0,1,1,3,2,0,0,0,0,1,1,4,3
DG_F3_093,5,0,0,0,0,2,2,1,0,0,0,0,0,2,2,3,2
DG_F3_094,5,0,0,0,0,1,4,0,1,0,0,0,0,1,4,1,5
DG_F3_095,5,0,0,0,1,2,0,0,3,0,0,0,1,2,1,2,4
DG_F3_096,5,0,0,1,1,1,2,0,2,0,0,1,1,2,3,2,5
DG_F3_097,5,0,0,0,0,2,5,2,0,0,0,0,0,2,5,4,5
DG_F3_098,5,0,0,7,2,0,3,7,0,0,0,7,2,7,5,14,5
DG_F3_099,5,0,0,0,3,3,1,1,2,0,0,0,3,3,4,4,6
DG_F3_101,5,0,0,1,5,3,4,2,3,0,0,1,5,4,9,6,12
DG_F3_102,5,0,0,2,0,1,2,3,4,0,0,2,0,3,2,6,6
DG_F3_103,5,0,0,0,0,2,5,4,2,0,0,0,0,2,5,6,7
DG_F3_106,5,0,0,0,0,0,3,2,3,0,0,0,0,0,3,2,6
DG_F3_107,5,0,0,0,0,1,0,1,0,0,0,0,0,1,0,2,0
DG_F3_115,5,0,0,0,0,1,1,3,2,0,0,0,0,1,1,4,3
DG_F3_118,5,0,0,2,0,2,4,1,2,0,0,2,0,4,4,5,6
DG_F3_119,5,0,0,2,3,2,1,2,2,0,0,2,3,4,4,6,6
DG_F3_120,5,0,0,0,0,0,6,6,1,0,0,0,0,0,6,6,7
DG_F3_121,5,0,0,0,0,3,2,5,2,0,0,0,0,3,2,8,4
DG_F3_124,5,0,0,0,0,0,0,0,0,0,0,0,0,0,0,0,0
DG_F3_126,5,0,0,1,1,4,1,4,1,0,0,1,1,5,2,9,3
DG_F3_127,5,0,0,0,1,4,0,6,2,0,0,0,1,4,1,10,3
DG_F3_129,5,0,0,3,2,2,1,4,0,0,0,3,2,5,3,9,3
DG_F3_131,5,0,0,3,4,2,5,5,1,0,0,3,4,5,9,10,10
DG_F3_132,5,0,0,5,2,5,6,4,3,0,0,5,2,10,8,14,11
DG_F3_133,5,0,0,2,3,2,1,5,1,0,0,2,3,4,4,9,5
DG_F3_136,5,0,0,2,3,4,1,4,2,0,0,2,3,6,4,10,6
DG_F3_139,5,0,0,1,2,1,4,1,2,0,0,1,2,2,6,3,8
DG_F3_145,5,0,0,0,0,0,0,3,1,0,0,0,0,0,0,3,1
DG_F3_150,5,0,0,3,3,0,3,4,4,0,0,3,3,3,6,7,10
DG_F3_152,5,0,0,0,2,2,8,3,1,0,0,0,2,2,10,5,11
DG_F3_154,5,0,0,1,7,4,2,6,3,0,0,1,7,5,9,11,12
DG_F3_157,5,0,0,1,0,2,0,2,2,0,0,1,0,3,0,5,2
DG_F3_159,5,0,0,0,0,0,1,1,0,0,0,0,0,0,1,1,1
DG_F3_163,5,0,0,1,2,1,3,2,3,0,0,1,2,2,5,4,8
DG_F3_164,5,0,0,0,0,2,1,1,1,0,0,0,0,2,1,3,2
DG_F3_165,5,0,0,0,1,1,0,4,4,0,0,0,1,1,1,5,5
DG_F3_167,5,0,0,0,0,0,0,0,0,0,0,0,0,0,0,0,0
DG_F3_175,5,0,0,1,0,0,0,2,0,0,0,1,0,1,0,3,0
DG_F3_179,5,0,0,0,2,2,0,2,1,0,0,0,2,2,2,4,3
DG_F3_180,5,0,0,2,0,1,2,5,7,0,0,2,0,3,2,8,9
DG_F3_185,5,0,0,0,0,2,1,3,0,0,0,0,0,2,1,5,1
DG_F3_190,5,0,0,4,3,4,2,3,3,0,0,4,3,8,5,11,8
DG_F3_194,5,0,0,1,1,1,3,0,0,0,0,1,1,2,4,2,4
DG_F3_195,5,0,0,0,1,0,1,0,0,0,0,0,1,0,2,0,2
DG_F3_196,5,0,0,0,0,0,0,1,0,0,0,0,0,0,0,1,0
DG_F3_200,5,0,0,1,0,0,0,0,0,0,0,1,0,1,0,1,0
DG_F3_203,5,0,0,0,0,0,0,0,0,0,0,0,0,0,0,0,0
DG_F3_210,5,0,0,0,0,1,3,1,1,0,0,0,0,1,3,2,4
DG_F3_212,5,0,0,0,0,2,0,4,0,0,0,0,0,2,0,6,0
DG_F3_214,5,0,0,0,0,0,0,0,0,0,0,0,0,0,0,0,0
DG_F3_218,5,0,0,0,1,2,8,6,2,0,0,0,1,2,9,8,11
DG_F3_220,5,0,0,0,0,1,3,5,2,0,0,0,0,1,3,6,5
DG_F3_223,5,0,0,2,2,2,6,6,5,0,0,2,2,4,8,10,13
DG_F3_225,5,0,0,2,1,1,0,1,0,0,0,2,1,3,1,4,1
DG_F3_227,5,0,0,0,1,2,2,1,1,0,0,0,1,2,3,3,4
DG_F3_230,5,0,0,1,1,0,3,1,1,0,0,1,1,1,4,2,5
DG_F3_231,5,0,0,1,1,0,0,0,0,0,0,1,1,1,1,1,1
DG_F3_232,5,0,0,2,0,0,2,2,3,0,0,2,0,2,2,4,5
DG_F3_236,5,0,0,2,2,0,0,1,3,0,0,2,2,2,2,3,5
DG_F3_239,5,0,0,0,0,0,0,0,0,0,0,0,0,0,0,0,0
DG_F3_241,5,0,0,0,0,0,0,0,0,0,0,0,0,0,0,0,0
DG_F3_245,5,0,0,1,6,5,0,0,0,0,0,1,6,6,6,6,6
DG_F3_246,5,0,0,3,3,7,1,2,2,0,0,3,3,10,4,12,6
DG_F3_247,5,0,0,0,0,0,0,0,0,0,0,0,0,0,0,0,0
DG_F3_248,5,0,0,1,4,6,1,4,0,0,0,1,4,7,5,11,5
DG_F3_249,5,0,0,1,0,1,0,2,1,0,0,1,0,2,0,4,1
DG_F3_250,5,0,0,2,0,3,1,13,3,0,0,2,0,5,1,18,4
DG_F3_255,5,0,0,0,0,0,0,0,0,0,0,0,0,0,0,0,0
DG_F3_257,5,0,0,0,0,0,0,0,0,0,0,0,0,0,0,0,0
DG_F3_263,5,0,0,0,1,1,0,0,0,0,0,0,1,1,1,1,1
DG_F3_266,5,0,0,5,3,3,3,2,1,0,0,5,3,8,6,10,7
DG_F3_269,5,0,0,2,2,2,2,4,5,0,0,2,2,4,4,8,9
DG_F3_270,5,0,0,0,1,1,1,2,1,0,0,0,1,1,2,3,3
DG_F3_271,5,0,0,4,5,0,0,6,2,0,0,4,5,4,5,10,7
DG_F3_273,5,0,0,3,4,3,2,9,1,0,0,3,4,6,6,15,7
DG_F3_274,5,0,0,1,2,1,0,1,1,0,0,1,2,2,2,3,3
DG_F3_276,5,0,0,0,0,0,1,0,0,0,0,0,0,0,1,0,1
DG_F3_280,5,0,0,0,1,1,2,1,1,0,0,0,1,1,3,2,4
DG_F3_283,5,0,0,0,1,1,2,2,0,0,0,0,1,1,3,3,3
DG_F3_285,5,0,0,0,0,5,0,2,0,0,0,0,0,5,0,7,0
DG_F3_286,5,0,0,1,1,1,1,3,2,0,0,1,1,2,2,5,4
DG_F3_287,5,0,0,5,4,4,4,6,5,0,0,5,4,9,8,15,13
DG_F3_292,5,0,0,0,0,0,0,0,1,0,0,0,0,0,0,0,1
DG_F3_293,5,0,0,1,1,0,0,2,0,0,0,1,1,1,1,3,1
DG_F3_294,5,0,0,0,0,0,0,0,0,0,0,0,0,0,0,0,0
DG_F3_297,5,0,0,0,0,0,0,0,0,0,0,0,0,0,0,0,0
DG_F3_298,5,0,0,0,0,0,0,0,0,0,0,0,0,0,0,0,0
DG_F3_299,5,0,0,0,0,0,0,0,0,0,0,0,0,0,0,0,0
DG_F3_300,5,0,0,0,0,1,2,2,2,0,0,0,0,1,2,3,4
DG_F3_302,5,0,0,0,0,4,4,3,1,0,0,0,0,4,4,7,5
DG_F3_304,5,0,0,0,0,1,1,5,2,0,0,0,0,1,1,6,3
DG_F3_305,5,0,0,2,1,4,2,1,1,0,0,2,1,6,3,7,4
DG_F3_307,5,0,0,0,0,0,2,1,0,0,0,0,0,0,2,1,2
DG_F3_309,5,0,0,0,3,3,0,3,2,0,0,0,3,3,3,6,5
DG_F3_312,5,0,0,0,0,1,1,4,8,0,0,0,0,1,1,5,9
DG_F3_315,5,0,0,2,3,7,2,2,2,0,0,2,3,9,5,11,7
DG_F3_316,5,0,0,4,3,3,4,0,2,0,0,4,3,7,7,7,9
DG_F3_317,5,0,0,1,1,2,0,0,2,0,0,1,1,3,1,3,3
DG_F3_318,5,0,0,0,2,0,1,0,0,0,0,0,2,0,3,0,3
DG_F3_324,5,0,0,2,0,7,0,2,1,0,0,2,0,9,0,11,1
DG_F3_325,5,0,0,1,2,2,1,2,2,0,0,1,2,3,3,5,5
DG_F3_328,5,0,0,2,0,1,0,1,1,0,0,2,0,3,0,4,1
DG_F3_329,5,0,0,0,0,0,1,3,3,0,0,0,0,0,1,3,4
DG_F3_330,5,0,0,1,0,2,1,2,2,0,0,1,0,3,1,5,3
DG_F3_331,5,0,0,0,0,0,0,0,0,0,0,0,0,0,0,0,0
DG_F3_332,5,0,0,1,1,4,2,0,1,0,0,1,1,5,3,5,4
DG_F3_333,5,0,0,2,0,1,0,0,0,0,0,2,0,3,0,3,0
DG_F3_334,5,0,0,0,0,2,1,3,2,0,0,0,0,2,1,5,3
DG_F3_335,5,0,0,0,1,3,2,1,1,0,0,0,1,3,3,4,4
DG_F3_336,5,0,0,1,2,3,2,0,1,0,0,1,2,4,4,4,5
DG_F3_337,5,0,0,0,3,1,2,7,4,0,0,0,3,1,5,8,9
DG_F3_338,5,0,0,2,2,2,0,0,0,0,0,2,2,4,2,4,2
DG_F3_342,5,0,0,0,1,2,0,6,5,0,0,0,1,2,1,8,6
DG_F3_344,6,0,0,0,0,0,0,0,2,0,0,0,0,0,0,0,2
DG_F3_345,6,0,0,0,0,0,0,5,3,0,0,0,0,0,0,5,3
DG_F3_346,6,0,0,2,1,1,0,3,5,0,0,2,1,3,1,6,6
DG_F3_349,6,0,0,0,0,0,0,3,0,0,0,0,0,0,0,3,0
DG_F3_351,6,0,0,0,0,0,0,2,2,0,0,0,0,0,0,2,2
DG_F3_352,6,0,0,4,4,2,1,6,3,0,0,4,4,6,5,12,8
DG_F3_354,6,0,0,3,2,3,7,3,1,0,0,3,2,6,9,9,10
DG_F3_355,6,0,0,3,3,2,5,14,5,0,0,3,3,5,8,19,13
DG_F3_356,6,0,0,3,2,5,8,13,10,0,0,3,2,8,10,21,20
DG_F3_357,6,0,0,4,3,4,2,8,1,0,0,4,3,8,5,16,6
DG_F3_360,6,0,0,1,2,2,3,10,3,0,0,1,2,3,5,13,8
DG_F3_363,6,0,0,2,6,2,4,5,1,0,0,2,6,4,10,9,11
DG_F3_364,6,0,0,7,2,2,3,4,0,0,0,7,2,9,5,13,5
DG_F3_365,6,0,0,2,2,3,1,3,0,0,0,2,2,5,3,8,3
DG_F3_366,6,0,0,4,3,3,3,4,6,0,0,4,3,7,6,11,12
DG_F3_367,6,0,0,5,2,2,3,7,1,0,0,5,2,7,5,14,6
DG_F3_368,6,0,0,0,2,0,1,1,1,0,0,0,2,0,3,1,4
DG_F3_369,6,0,0,2,3,1,3,2,1,0,0,2,3,3,6,5,7
DG_F3_370,6,0,0,1,0,2,1,0,0,0,0,1,0,3,1,3,1
DG_F3_371,6,0,0,3,1,2,4,10,5,0,0,3,1,5,5,15,10
DG_F3_372,6,0,0,2,4,2,4,9,4,0,0,2,4,4,8,13,12
DG_F3_375,6,0,0,2,0,3,0,2,0,0,0,2,0,5,0,7,0
DG_F3_376,6,0,0,1,4,3,1,5,2,0,0,1,4,4,5,9,7
DG_F3_377,6,0,0,0,0,1,0,1,0,0,0,0,0,1,0,2,0
DG_F3_378,6,0,0,0,0,0,0,0,0,0,0,0,0,0,0,0,0
DG_F3_381,6,0,0,0,2,4,1,5,2,0,0,0,2,4,3,9,5
DG_F3_384,6,0,0,0,0,0,0,3,1,0,0,0,0,0,0,3,1
DG_F3_385,6,0,0,0,0,1,1,0,0,0,0,0,0,1,1,1,1
DG_F3_386,6,0,0,1,0,0,1,0,0,0,0,1,0,1,1,1,1
DG_F3_387,6,0,0,0,0,0,0,0,0,0,0,0,0,0,0,0,0
DG_F3_388,6,0,0,3,4,2,3,12,3,0,0,3,4,5,7,17,10
DG_F3_389,6,0,0,2,3,2,6,6,3,0,0,2,3,4,9,10,12
DG_F3_402,6,0,0,0,4,2,3,4,1,0,0,0,4,2,7,6,8
DG_F3_403,6,0,0,1,0,3,2,9,3,0,0,1,0,4,2,13,5
DG_F3_405,6,0,0,0,3,3,0,2,1,0,0,0,3,3,3,5,4
DG_F3_406,6,0,0,1,2,5,1,2,2,0,0,1,2,6,3,8,5
DG_F3_411,6,0,0,0,0,1,0,5,2,0,0,0,0,1,0,6,2
DG_F3_412,6,0,0,1,2,2,0,8,0,0,0,1,2,3,2,11,2
DG_F3_415,6,0,0,1,0,1,2,3,1,0,0,1,0,2,2,5,3
DG_F3_418,6,0,0,2,0,1,1,2,2,0,0,2,0,3,1,5,3
DG_F3_426,6,0,0,2,6,5,3,7,1,0,0,2,6,7,9,14,10
DG_F3_430,6,0,0,0,0,0,0,5,2,0,0,0,0,0,0,5,2
DG_F3_433,6,0,0,1,1,1,3,12,3,0,0,1,1,2,4,14,7
DG_F3_437,6,0,0,0,0,1,1,2,4,0,0,0,0,1,1,3,5
DG_F3_439,6,0,0,0,0,0,0,1,1,0,0,0,0,0,0,1,1
DG_F3_441,6,0,0,0,2,1,1,2,1,0,0,0,2,1,3,3,4
DG_F3_442,6,0,0,5,4,3,1,5,2,0,0,5,4,8,5,13,7
DG_F3_443,6,0,0,2,0,0,1,3,2,0,0,2,0,2,1,5,3
DG_F3_444,6,0,0,0,0,0,0,3,0,0,0,0,0,0,0,3,0
DG_F3_448,6,0,0,5,1,0,7,6,5,0,0,5,1,5,8,11,13
DG_F3_449,6,0,0,0,0,0,1,4,1,0,0,0,0,0,1,4,2
DG_F3_453,6,0,0,0,1,1,1,1,4,0,0,0,1,1,2,2,6
DG_F3_456,6,0,0,2,0,1,0,1,1,0,0,2,0,3,0,4,1
DG_F3_458,6,0,0,1,2,4,4,7,10,0,0,1,2,5,6,12,16
DG_F3_459,6,0,0,0,1,0,1,4,0,0,0,0,1,0,2,4,2
DG_F3_460,6,0,0,0,1,4,5,9,2,0,0,0,1,4,6,13,8
DG_F3_461,6,0,0,1,0,1,0,5,6,0,0,1,0,2,0,7,6
DG_F3_462,6,0,0,0,0,0,0,7,4,0,0,0,0,0,0,7,4
DG_F3_463,6,0,0,0,0,0,3,11,6,0,0,0,0,0,3,11,9
DG_F3_464,6,0,0,2,0,2,1,5,4,0,0,2,0,4,1,9,5
DG_F3_465,6,0,0,0,1,2,2,3,3,0,0,0,1,2,3,5,6
DG_F3_469,6,0,0,0,0,0,1,11,3,0,0,0,0,0,1,11,4
DG_F3_473,6,0,0,2,0,3,1,14,8,0,0,2,0,5,1,19,9
DG_F3_477,6,0,0,0,0,0,0,0,0,0,0,0,0,0,0,0,0
DG_F3_478,6,0,0,3,3,2,4,14,4,0,0,3,3,5,7,19,11
DG_F3_479,6,0,0,1,2,4,3,5,6,0,0,1,2,5,5,10,11
DG_F3_482,6,0,0,1,2,0,4,8,2,0,0,1,2,1,6,9,8
DG_F3_483,6,0,0,0,1,2,0,10,6,0,0,0,1,2,1,12,7
DG_F3_485,6,0,0,0,1,1,6,5,2,0,0,0,1,1,7,6,9
DG_F3_487,6,0,0,1,2,0,5,7,6,0,0,1,2,1,7,8,13
DG_F3_493,6,0,0,0,0,0,1,0,1,0,0,0,0,0,1,0,2
DG_F3_495,6,0,0,0,0,0,1,1,2,0,0,0,0,0,1,1,3
DG_F3_496,6,0,0,0,0,0,0,0,0,0,0,0,0,0,0,0,0
DG_F3_497,6,0,0,0,0,0,0,0,1,0,0,0,0,0,0,0,1
DG_F3_498,6,0,0,0,0,0,0,0,0,0,0,0,0,0,0,0,0
DG_F3_502,6,0,0,1,0,2,0,10,2,0,0,1,0,3,0,13,2
DG_F3_504,6,0,0,0,1,1,2,3,3,0,0,0,1,1,3,4,6
DG_F3_506,6,0,0,0,0,0,3,6,2,0,0,0,0,0,3,6,5
DG_F3_507,6,0,0,0,0,0,0,4,0,0,0,0,0,0,0,4,0
DG_F3_509,6,0,0,1,1,4,1,9,2,0,0,1,1,5,2,14,4
DG_F3_510,6,0,0,3,3,0,1,4,7,0,0,3,3,3,4,7,11
DG_F3_511,6,0,0,5,0,3,9,10,7,0,0,5,0,8,9,18,16
DG_F3_513,6,0,0,1,1,0,3,2,4,0,0,1,1,1,4,3,8
DG_F3_517,6,0,0,3,1,3,5,5,7,0,0,3,1,6,6,11,13
DG_F3_521,6,0,0,3,4,4,5,6,2,0,0,3,4,7,9,13,11
DG_F3_523,6,0,0,1,3,2,2,1,2,0,0,1,3,3,5,4,7
DG_F3_524,6,0,0,3,1,2,0,9,2,0,0,3,1,5,1,14,3
DG_F3_525,6,0,0,1,2,3,5,8,10,0,0,1,2,4,7,12,17
DG_F3_527,6,0,0,1,4,5,3,14,7,0,0,1,4,6,7,20,14
DG_F3_532,6,0,0,2,2,3,2,4,2,0,0,2,2,5,4,9,6
DG_F3_534,6,0,0,1,2,2,2,14,12,0,0,1,2,3,4,17,16
DG_F3_536,6,0,0,0,0,2,1,8,1,0,0,0,0,2,1,10,2
DG_F3_538,6,0,0,4,3,0,7,11,5,0,0,4,3,4,10,15,15
DG_F3_540,6,0,0,0,2,3,1,4,7,0,0,0,2,3,3,7,10
DG_F3_543,6,0,0,0,0,0,0,1,2,0,0,0,0,0,0,1,2
DG_F3_544,6,0,0,1,1,3,2,3,3,0,0,1,1,4,3,7,6
DG_F3_545,6,0,0,0,0,1,1,4,1,0,0,0,0,1,1,5,2
DG_F3_546,6,0,0,1,0,0,0,2,5,0,0,1,0,1,0,3,5
DG_F3_547,6,0,0,1,0,2,1,11,3,0,0,1,0,3,1,14,4
DG_F3_548,6,0,0,0,1,2,5,11,5,0,0,0,1,2,6,13,11
DG_F3_549,6,0,0,0,0,1,0,9,3,0,0,0,0,1,0,10,3
DG_F3_550,6,0,0,1,0,2,5,13,3,0,0,1,0,3,5,16,8
DG_F3_551,6,0,0,0,0,0,2,6,1,0,0,0,0,0,2,6,3
DG_F3_556,6,0,0,1,0,3,1,0,1,0,0,1,0,4,1,4,2
DG_F3_561,6,0,0,2,0,0,0,2,2,0,0,2,0,2,0,4,2
DG_F3_562,6,0,0,1,0,1,0,5,2,0,0,1,0,2,0,7,2
DG_F3_563,6,0,0,0,2,0,3,1,3,0,0,0,2,0,5,1,8
DG_F3_565,6,0,0,0,0,4,1,1,0,0,0,0,0,4,1,5,1
DG_F3_566,6,0,0,0,0,0,0,0,0,0,0,0,0,0,0,0,0
DG_F3_568,6,0,0,0,0,0,1,0,3,0,0,0,0,0,1,0,4
DG_F3_573,6,0,0,1,0,0,2,7,7,0,0,1,0,1,2,8,9
DG_F3_581,6,0,0,2,1,0,1,5,1,0,0,2,1,2,2,7,3
DG_F3_582,6,0,0,0,1,1,3,8,6,0,0,0,1,1,4,9,10
DG_F3_585,6,0,0,0,0,2,2,4,5,0,0,0,0,2,2,6,7
DG_F3_589,6,0,0,0,0,0,0,3,2,0,0,0,0,0,0,3,2
DG_F3_592,6,0,0,0,1,2,1,5,4,0,0,0,1,2,2,7,6
DG_F3_594,6,0,0,0,0,1,0,3,3,0,0,0,0,1,0,4,3
DG_F3_595,6,0,0,0,0,0,0,11,6,0,0,0,0,0,0,11,6
DG_F3_598,6,0,0,0,1,0,3,7,4,0,0,0,1,0,4,7,8
DG_F3_602,6,0,0,2,1,0,0,5,3,0,0,2,1,2,1,7,4
DG_F3_604,6,0,0,1,1,1,2,7,7,0,0,1,1,2,3,9,10
DG_F3_606,6,0,0,0,1,1,3,9,9,0,0,0,1,1,4,10,13
DG_F3_607,6,0,0,2,1,3,2,3,3,0,0,2,1,5,3,8,6
DG_F3_608,6,0,0,0,0,0,0,4,1,0,0,0,0,0,0,4,1
DG_F3_609,6,0,0,0,0,0,1,3,1,0,0,0,0,0,1,3,2
DG_F3_610,6,0,0,0,0,1,1,6,5,0,0,0,0,1,1,7,6
DG_F3_611,6,0,0,0,2,0,5,4,3,0,0,0,2,0,7,4,10
DG_F3_612,6,0,0,3,1,3,3,12,10,0,0,3,1,6,4,18,14
DG_F3_613,6,0,0,0,0,0,0,2,0,0,0,0,0,0,0,2,0
DG_F3_614,6,0,0,1,0,0,0,3,6,0,0,1,0,1,0,4,6
DG_F3_617,6,0,0,1,4,4,7,12,5,0,0,1,4,5,11,17,16
DG_F3_618,6,0,0,2,0,2,2,2,4,0,0,2,0,4,2,6,6
DG_F3_619,6,0,0,0,0,1,0,7,9,0,0,0,0,1,0,8,9
DG_F3_620,6,0,0,1,1,2,1,3,1,0,0,1,1,3,2,6,3
DG_F3_621,6,0,0,2,0,5,3,9,7,0,0,2,0,7,3,16,10
DG_F3_624,6,0,0,1,2,6,4,4,4,0,0,1,2,7,6,11,10
DG_F3_628,6,0,0,1,2,6,3,9,10,0,0,1,2,7,5,16,15
DG_F3_630,6,0,0,3,0,3,3,6,1,0,0,3,0,6,3,12,4
DG_F3_632,6,0,0,0,0,2,0,9,4,0,0,0,0,2,0,11,4
DG_F3_633,6,0,0,0,2,1,2,2,1,0,0,0,2,1,4,3,5
DG_F3_634,6,0,0,2,0,1,0,6,5,0,0,2,0,3,0,9,5
DG_F3_635,6,0,0,0,0,2,6,8,3,0,0,0,0,2,6,10,9
DG_F3_636,6,0,0,3,0,3,7,7,1,0,0,3,0,6,7,13,8
DG_F3_638,6,0,0,0,0,0,0,0,0,0,0,0,0,0,0,0,0
DG_F3_639,6,0,0,1,0,3,5,7,1,0,0,1,0,4,5,11,6
DG_F3_640,6,0,0,0,2,2,1,6,2,0,0,0,2,2,3,8,5
DG_F3_641,6,0,0,0,0,1,2,0,2,0,0,0,0,1,2,1,4
DG_F3_642,6,0,0,0,0,0,0,2,0,0,0,0,0,0,0,2,0
DG_F3_643,6,0,0,0,0,0,0,7,1,0,0,0,0,0,0,7,1
DG_F3_644,6,0,0,0,1,1,0,5,2,0,0,0,1,1,1,6,3
